111111111111111111111111111111111111111111111111111111111
100000000000000000000000000000000000000000000000000000001
101111111111111111101111111111111111101111111111111111101
101000000000000000101000000000000000101000000000000000101
101011111111111111101011111101111110101111111111111110101
101000000000000000101010000111000010111000000000000000101
101111111111111110100010110000011010001011111111111111101
101000000000000000101010100101001010101000000000000000101
101011111111111111101000101101101000101111111111111110101
101010000000000000001110100000001011100000000000000010101
100010111111011111101000101101101000101111110111111010001
101110100001110000101010100101001010101000011100001011101
101000101100000110101010110000011010101011000001101000101
101010101001010010101010000111000010101010010100101010101
101010001011011010001011111101111110100010110110100010101
101011101000000010111000000000000000111010000000101110101
101010001011011010001011111101111110100010110110100010101
101010101001010010101010000111000010101010010100101010101
101000101100000110101010110000011010101011000001101000101
101110100001110000101010100101001010101000011100001011101
100010111111011111101000101101101000101111110111111010001
111010000000000000001110100000001011100000000000000010111
100010111111011111101000101101101000101111110111111010001
101110100001110000101010100101001010101000011100001011101
101000101100000110101010110000011010101011000001101000101
101010101001010010101010000111000010101010010100101010101
101010001011011010001011111101111110100010110110100010101
10101110100000001011100000000000000011101000G000101110101
101010001011011010001011111101111110100010110110100010101
101010101001010010101010000111000010101010010100101010101
101000101100000110101010110000011010101011000001101000101
101110100001110000101010100101001010101000011100001011101
100010111111011111101000101101101000101111110111111010001
101010000000000000001110100000001011100000000000000010101
101011111111111111101000101101101000101111111111111110101
101000000000000000101010100101001010101000000000000000101
101111111111111110100010110000011010001011111111111111101
101000000000000000111010000111000010101000000000000000101
101011111111111111101011111101111110101111111111111110101
101000000000000000101000000000000000101000000000000000101
101111111111111111101111111111111111101111111111111111101
100000000000000000000000000000000000000000000000000000001
111111111111111111111111111111111111111111111111111111111